111111111111111111111111111111111111111111111111111111111111111111111111111111111111111111111111111111111111111111111111111111111111111111111111111111111111111111111111111111111111111111111111111111111111111111111111111111111111111111111111111111111111111111111111111111111111111111111111111111111111111111111111111111111111111111111111111111111111111111111111111111111111111111111111111111111111111111111111111111111111111111111111111111111111111111111111111111111111111111111111111111111111111111
111111111111111111111100000000111000000000000000000000000001111111111111111110000000000000000000000000000000000000000011111111111111111111111111111111111111111111111110000000000001000000000000000000000000000011111111111111111111111111110000000000000000000000000000000000000000000000000000000000000001111111111111111111000000000000000000000000000000000000000000000000000000000000000000000000000000000000000000000000000000000000000000000000000000000000000000000000000000000000000000000000000001111111
111111111111111111111100000000000000000000000000000000000000011111111111111000000000000000000000000000000000000000000000000000000000000000000000000000000000000000000000000000000001000000000000000000000000000000000000000000011111111111110000000000000000000000000000000000000000000000000000000000000001111111111111111111000000000000000000000000000000000000000000000000000000000000000000000000000000000000000000000000000000000000000000000000000000000000000000000000000000000000000000000000000001111111
111111111111111111111100000000000000000000000000000000000000011111111111111000000000000000000000000000000000000000000000000000000000000000000000000000000000000000000000000000000001000000000000000000000000000000000000000000011111111111110000000000000000000000000000000000000000000000000000000000000001111111111111111111000000000000000000000000000000000000000000000000000000000000000000000000000000000000000000000000000000000000000000000000000000000000000000000000000000000000000000000000000001111111
111111111111111111111100000000000000000000000000000000000000011111111111111000000000000000000000000000000000000000000000000000000000000000000000000000000000000000000000000000000001000000000000000000000000000000000000000000090909000000110000000000000000000000000111111111111111111111110000000000000001111111111111111111000000000000000000000000000000000000000000000000000000000000000000000000000000000000000000000000000000000000000000000000000000000000000000000000000000000000000000000000000001111111
111111111111111111111100000000000000000000000000000000000000000000000000000000000000000000000000000000000000000000000000000000000000000000000000000000000000000000000000000000000001000000000000000000000000000000000000000000090909000000110000000000000000000000000111111111111111190909090000090909090900000001111111111111000000000000000000000000000000000000000000000000000000000000000000000000000000000000000000000000000000000000000000000000000000040030032440040010000400100400423330011000100001111111
111111111111111111111100000000000000000000000000000000000000000000000000000000000000000000000000000000000000000000000000000000000000000000000000000000000000000000000000000000000001000000000011111111100000000000000000000000090909000000110000000000000000011111111111111111111111190909090000090909090900000001111111111111000000000000000000000000000000000000000000000000000000000000000000000000000000000000000000000000000000000000000000000000000000010010010010010010000100100100001000011000100001111111
111111111111111111111100000000000000000000000000000000000000000000000000000000000000000000000000000000000000000000000000000000000000000000000000000000000000000000000000000000000001000000000000000000100000000000000000000000090909000000110000000000000000000000000011111111111111190909090000090909090900000001111111111111000000000000000000000000000000000000000000000000000000000000000000000000000000000000000000000000000000000000000000000000000000011110010010010010000100100100001000010100100001111111
111111111111111111111100000000000000000000000000000000000000000000000000000000000000000000008000000000000000000000000000000000000000000000000000000000000000000000000000000000000001000000000000000000100000000000000000000000090909000000110000000000000000000000000011111111111111190909090000090909090900000001111111111111000000000000000000000000000000000000000000000000000000000000000000000000000000000000000000000000000000000000000000000000000000000010010010010010000100100100001000010010100001111111
111111111111111111111100000000000000000000000000000000000000000000000000000000000000000011111111111111110000011111111100000001111111000000000000000000000000000000000000000000000001000000000000000000100000000000000000000000090909000000110000000800000000000000000011111111111111190909090000090909090900000001111111111111000000000000000000000000000000000000000000000000000000000000000000000000000000000000000000000000000000000000000000000000000000011110011110011110000111111100111110010001100001111111
111111111111111111111100000000000000000000000000000000000000000000000000000000000000000000000000000000000000000000000000000000000000000000000900000000000000000000000000000000000001800000000000000000100000000000000000000000090909000000110000000000000000000000000011111111111111190909090000090909090900000001111111111111000000000000000000000000000000000000000000000000000000000000000000000000000000000000000000000000000000000000000000000000000000000000000000000000000000000000000000000000000001111111
111111111111111111111100000000000000000011111000000000000000000000000000000000000000000000000000000000000000000000000000000000000000000000000111111110000000000000000000000000000001111111110000000000100000000000000000000000090909000000110000000000000000000000000011111111111111190909090000090909090900000001111111111111000000000000011111111111100000000000000000000000000000000000000000000000000000000000000000000000000900000000000000000000000000000000000000000000000000000000000000000000000001111111
111111111111111111111170000000011000000000000000000000000000000000000000000000000000000000000000000000000000000000000000000000000000000000000111111119000000000000000000000000000000000000000000000000100000000000000000000000090909000000110000000000000000000000000011111111111111190909090000090909090900000001111111111111700000000000000000011111100000888000008880000088800000888000008880000088800000888000008880000000000111111111100000000000000000000000000000000000000000000000000000000000000001111111
111111111111111111111133324444444000000000000000000000000000000000000000000000000000000000000000000007000000000000000000000000000000000000000111111111111111100000000000000000000000000000000000000000100000000000000000000000090909000000110000000000000000000000000011100000000001190909090000090909090900000001111111111111111111111000000000099999999999000999990009999900099999000999990009999900099999000999990009999988888000000001100000000000000000000000000000000000000000000000000000000000000001111111
111111111111111111111100000000000000000000000000000000000000000000000000000000000000000001111111111111111111111111111100000000000000000000000111111111111111100000000000000000000000000000000000000000190909090909090000000000090909000000110080000000000000000000000011190000000001190909090000090909090900000001111111111111000000000000000000011111111111111111111111111111111111111111111111111111111111111111111111111111111111111111111111110000000000000000000000000000000000000000000000000000000001111111
111111111111111111111100000000000000000000000000111111000001111100001111100000011111100000000000000000000000000000000110000000000000000000000111111111111111190000000000000000000000000000000111111111111111111111111111111000090909000000110000000000000000000000000011111111111111190909090000090909090900000001111111111111000000000000000000011111111111111111111111111111111111111111111111111111111111111111111111111111111111111111111111110000000000000000000000000000000000000000000000000000000001111111
111111111111111111111100000000000000001111110000111111000000000000000000000000011111100000000000000000000000000000000111000000000000000000000111111111111111111111111100000000000000000000000000000000111111111111111111111000011111111111110000000000000000000000000011111111111111190909090000090909090900000001111111111111000000000000000011111111111111111111111111111111111111111111111111111111111111111111111111111111111111111111111111110000000000000000000000000000000000000000000000000000000001111111
111111111111111111111100000000000000000000000000111111000000000000000000000000011111100000000000000900000000000000000111100000000000000000000111111111111111111111111100000000000000000000000000000000111111111111110000000000000000000000000000000000000000000000000011111111111111100000000000000000000000000000000000000000000000000000000000000001111111111111111111111111111111111111111111111111111111111111111111111111111111111111111111110000000000000000000000000000000000000000000000000000000001111111
111111111111111111111100000000000000000000000000111111090000900009000090000000011111111111111111111111111111111111111111110000000000000000000111111111111111111111111100000000000070000000000000000000111111111111118888800000000000000000000000000000000000000000000011111111111111100000000000000000000000000000000000000000000000000000000000000001111111111111111111111111111111111111111111111111111111111111111111111111111111111111111111110000000000000000000000000000000000000000000000000000000001111111
111111111111111111111133333244444333333333333333111111111111111111111111111111111111111111111111111111111111111111111111111111111111111111111111111111111111111111111111111111111111111111111111111111111111111111111111111111111111111111111111111111111111111111111111111111111111111111111111111111111111111111111111111111111111111111111111111111111111111111111111111111111111111111111111111111111111111111111111111111111111111111111111111111111111111111111111111111111111111111111111111111111111111111